tileset:ressources/assets/texture_basic.png
11111111111111111111
10010000000000000001
10011110110111110111
10000000000010000001
10000111011110000001
11101100000010000001
10000000000010000001
10111100011110111101
32222111112222222101
32222322232233322101
32222223222222222001
33333333333333333111
